%%%%%%%%%%%%%%%%%%%%%%%%%%%%%%%%%%%%%
%                                  P%
%   %%    %%     %%%%%%%%%%%%       %
%   %%    %%  %%%    %%             %
%  %%%%% %%%%%       %%      %%%%%  %
%   %%      %% %%      %%           %
%   %%      %%   %%%%%%%%%%%%%  %%  %
%  %%%%%%%%%%%%      %%       %%    %
%        %%          %%       %%    %
%  %%    %%         %%%%%%%%%%%%%%%%%                  
%  %%    %%%%%  %%       %%  %%  %%%%
%  %%           %%           %%  %%%%
%%%%%%%%%%%%  %%      %%%%          %
%   %%        %%%%%%%%%%%%%%        %
%   %%    %%          %%%%     %%%%%%       
%   %%    %%  %%%%      %%          %
%%%%%%%%  %%  %%%%   %%    %%%%%%%%%%         
%                %%%%%%%%          %%
%%%%%%%%%  %%%%%            %%%%   %%
%%%            %%                  %%
%      %%      %%    %%%%%   %%%%%%%%       
%   %%%%% %%   %%      %%         %%%
%      %%      %%%%%%%%%%%%%%%%   %%%
% %%%%%%%%  %%%    %%             %%%
% %%             %%%%               %
% %%  %%      %%%%%%%    %%%%%%%    %
% %%  %%           %%  %%%%%        %
%%%% %%%% %%%%%%%%%                 %
%                %%%%%%%%%%%%%%     %
% %%%%%  %%%%%%%%      %%           %
%                      %%      %%   %
% %%%  %%    %%%%%%%%%%%%%%%   %%   %
%      %%              %%  %%  %%   %
%     %%%%%%     %%        %%%      %
%%%%%%%          %%        %%       %
%.          %%%%%%%         %%      %
%%%%%%%%%%%%%%%%%%%%%%%%%%%%%%%%%%%%%
