%%%%%%%%%%%%%%%%%%%%%%%%%%%%%%%%%%%%%
%P                                  %
%                                   %
%                                   %
%                                   %
%                                   %
%                                   %
%                                   %
%                                   %
%                                   %
%                                   %
%                                   %
%                                   %
%                                   %
%                                   %
%                                   %
%                                   %
%                                   %
%                                   %
%                                   %
%                                   %
%                                   %
%                                   %
%                                   %
%                                   %
%                                   %
%                                   %
%                                   %
%                                   %
%                                   %
%                                   %
%                                   %
%                                   %
%                                   %
%                                   %
%.                                  %
%%%%%%%%%%%%%%%%%%%%%%%%%%%%%%%%%%%%%
