%%%%%%%%%%%%%%%%%%%%%%%%%%%%%%%%%%%%%
%                                  P%
% %% %%        %%%  %%%%%     %%%% %%
% %% %%     %%  %%%   %%            %
%   %%     %%%    %%    %%% %% %%%%%%
% %%                      %%%%      %
% %%          %% %%  %%%%    %%%%%%%%
%    %%            %%%     %%%      % 
% %% %%   %%   %% %%        %%%  %%%%
% %%     %%      %%   %%%% %%       %
%      %%%% %% %%%%      %% %%%%%%  %
%%%%%%              %%%% %%         %
%      %%%%%% %%%%      %%   %%%%%%%%
%%%%%%%%                 %% %%      %
%        %%%%%% %%    %%%%% %%    %%%
%%%%    %%                          %
%.                                  %
%%%%%%%%%%%%%%%%%%%%%%%%%%%%%%%%%%%%%
