%%%%%%%%%%%%%%%%%%%%%%%%%%%%%%%%%%%%%
%                                  P%
% %%%%%%%%%%%%%%%%%%%%%%% %%%%%%%%  %
% %%   %   %      %%%%%%%   %%      %
% %% % % % % %%%% %%%%%%%%% %% %%%% %
% %% % % % %             %% %%      %
% %% % % % % % %%%%  %%%    %%%%%%  %
% %  % % %   %     %% %%%%%%%%      % 
% %% % % %%%%%%%% %%        %% %%%%%%
% %% %   %%      %%%%%%%%% %%       %
%    %%%%%% %%%%%%%      %% %%%%%%  %
%%%%%%      %       %%%% %% %       %
%      %%%%%% %%%% %    %% %% %%%%% %
% %%%%%%      %       %%%%% %%      %
%        %%%%%% %%%%%%%%%%% %%    %%%
%%%%%%%%%%                  %%%%    %
%.         %%%%%%%%%%%%%%%%         %
%%%%%%%%%%%%%%%%%%%%%%%%%%%%%%%%%%%%%
