%%%%%%%
%    P%
%     %   
%     %
%     %
%.    %
%%%%%%%
