%%%%%%%
%    P%
% % % %
%  %  %
%%   %%
%. %%%%
%%%%%%%
